WWWWWWWWWWWWWWWWWW
W...W.......B....W
W.BBW.......SDD..W
W.BSW..W..DDDDD.SW
W.B.WW..W....WWWWW
WDDDD..W.........W
WDDD...W.B.......W
WBDDWDBBDSW......W
WDDDWGDDBDW....DBW
WSB.WDDDDDW...PDSW
WWWWWWWWWWWWWWWWWW