WWWWWWWWWWWWWWWWWW
W....B...W...W...W
W...DBDD.W...WP..W
W..DDSDD..DDDWWW.W
W..DWWWW..WDD....W
W..DDDDW..WDD....W
WGBDDSDW..WDDBDDDW
WBSDDDDW..WDDBDDDW
WBBDDDDW..WDDBDDDW
WWWWWWWWWWWWWWWWWW