WWWWWWWWWWWWWWWWWW
W.........WS.....W
W.........WD..D.BW
W.D..BDDD.W..DDDSW
W.DPDBDDDS......DW
W.DDDD...BDDW...DW
W...DD..DBDDWG..DW
W...DSD.DDDDDDDDDW
W.S.DDDWWW.DDD...W
WDDDD...SB.DD....W
WWWWWWWWWWWWWWWWWW
