WWWWWWWWWWWWWWWWWW
W...W....W.D..DDSW
W.S.W.DS.WDSD.DGBW
W.B.W.DDDW.DD.WWWW
WDDDWD.D.W.D.....W
W.D....D.B......SW
WD.S.....B....DBBW
WD.BD..WWWDD.WDBBW
WWWWW..W.BDDBWDBBW
W.S.DD.WSDDDBWDDPW
WWWWWWWWWWWWWWWWWW