WWWWWWWWWWWWWWWWWW
W.BSWSD...W...DS.W
W.BBWDDPBBW.B.DS.W
WDDDWDD.BSWBDBWWWW
W.......DDDDDDDBSW
W.............DBDW
W.............DDDW
WBBDWDDDDDW...WWWW
WDSDWDBSBDW....DDW
WDDDWDBDBDW....DGW
WWWWWWWWWWWWWWWWWW